111111111111111111111111
1P0000000001N000000N0001
10C0000C0001000000N00001
1000000000000000N0000001
1000000000000000N0000001
100000000000000000000001
1000C00000000000000C0001
100000000000000000000001
100000000000000000000001
100000000000000000000001
100000000N00000000000001
100000000000000000000001
100000000E000000C0000001
111111111111111111111111