1111111111111111111111111111111111111111111111111
10P0000111111111111111111111111111111111000000001
1000000011000000000000000000000000011000000000001
100000000110000C000000000000000000110000000000001
100000C00001100000000000000C0000011000000000C0001
1000000000001100000000000000000011000000000000001
100000000000011000000000000000011000000000C000001
10000000000C0011000C00000000011000000000000000001
1000000000000000110000000000110000000000000000001
1000000000000000011000000011000000000000000000001
1000000000000000001100C01100000011111100000000001
1000000000000000001111000000000000001000000000011
1000000000000000000111100000000000000100000000001
1001110000000000000110000000000000000100000000001
1000000000000000000110000000000000000000000010001
111111111110000000000000000000000000000001110E001
1111111111111111111111111111111111111111111111111