11111111111111111111
10000000000000011111
10000011000000001C01
100000C0000000000001
10P000C0000101110011
100000C0001101E00011
11111111111111111111