1111C111
10000001
10000001
10000001
11111111