1111111111111111111
1000000000000001111
1000001100000000001
100000C000000001101
10P000C000010001101
100000C0001100E0001
1111111111111111111