1111111111111111
10000C0C00010001
10P000000000C001
10000C0010E00001
10C000C000011001
1111111111111111