1111111111111111
1000000C00010001
10P000000000C001
1000000010E00001
10C000C000011001
1111111111111111