111111111111111111111111
1P0000000001000000C00001
10C0000C0001000000000001
100000000000000000000001
100000000000000000000001
1000000000000C0000000001
1000C00000000000000C0001
1000000000000CC000000001
100000000E000000C0000001
111111111111111111111111